**********************************************************
**********************************************************
**             *         *T                        *L*   *
**             *        ***                    T  ***    *
**                     K                                 *
**********************************************************
