*****************************************************************
*                          ***                                  *
*                          *L*       T                          *
*                   T      ***                                  *
**                         *                                    *
*                                                               *
*                           K                                   *
*****************************************************************
